Pick up all the water drops and reach the exit in time.
....................
.................X..
..........##########
....................
WWW....WWWW.........
---....####...s.....
....................
WWW.................
###...s.....WWWWW...
............#####...
....WWW.............
....###.............
...............s....
.1........W.W.W.W.W.
####################