Pick up all the water drops and reach the exit in time.
....................
.................X..
..........##########
....................
WWW....WWWW.........
---....####...s.....
.b..................
WWW.................
###...s.....WWWWW...
............#####...
....WWW.............
....###.............
..........a....s....
.1........W.W.W.W.W.
####################